%%%%%%%%%%%%%%%%%%%%%%%%%
%    P                  %
%                       %
%                     G %
%                       %
%                       %
%                       %
%                ..    o%
%%%%%%%%%%%%%%%%%%%%%%%%%
